----------------1111111111111111111111111111111111111111111111111111111111111111111111111111111111111------------------
----------------1-----------1-----------1-----------1-----------1-----------1-----------1-----------1------------------
----------------1-----------1-----------1-----------1-----------1-----------1-----------1-----------1------------------
----------------1----XXX----1----XXX----1----XXX----1----XXX----1----XXX----1----XXX----1----XXX----1------------------
----------------1----XXX----1----XXX----1----XXX----1----XXX----1----XXX----1----XXX----1----XXX----1------------------
----------------1----XXX----1----XXX----1----XXX----1----XXX----1----XXX----1----XXX----1----XXX----1------------------
----------------1----XXX----1----XXX----1----XXX----1----XXX----1----XXX----1----XXX----1----XXX----1------------------
----------------1----XXX----1----XXX----1----XXX----1----XXX----1----XXX----1----XXX----1----XXX----1------------------
----------------1----XXX----1----XXX----1----XXX----1----XXX----1----XXX----1----XXX----1----XXX----1------------------
----------------1----XXX----1----XXX----1----XXX----1----XXX----1----XXX----1----XXX----1----XXX----1------------------
----------------1----XXX----1----XXX----1----XXX----1----XXX----1----XXX----1----XXX----1----XXX----1------------------
----------------1----XXX----1----XXX----1----XXX----1----XXX----1----XXX----1----XXX----1----XXX----1------------------
----------------1----XXX----1----XXX----1----XXX----1----XXX----1----XXX----1----XXX----1----XXX----1------------------
----------------1----XXX----1----XXX----1----XXX----1----XXX----1----XXX----1----XXX----1----XXX----1------------------
----------------1----XXX----1----XXX----1----XXX----1----XXX----1----XXX----1----XXX----1----XXX----1------------------
----------------1----XXX----1----XXX----1----XXX----1----XXX----1----XXX----1----XXX----1----XXX----1------------------
----------------1----XXX----1----XXX----1----XXX----1----XXX----1----XXX----1----XXX----1----XXX----1------------------
----------------1----XXX----1----XXX----1----XXX----1----XXX----1----XXX----1----XXX----1----XXX----1------------------
----------------1----XXX----1----XXX----1----XXX----1----XXX----1----XXX----1----XXX----1----XXX----1------------------
----------------1----XXX----1----XXX----1----XXX----1----XXX----1----XXX----1----XXX----1----XXX----1------------------
----------------1-----------1-----------1-----------1-----------1-----------1-----------1-----------1------------------
----------------1-----------1-----------1-----------1-----------1-----------1-----------1-----------1------------------
----------------1111111111111111111111111111111111111111111111111111111111111111111111111111111111111------------------
----------------1----------------------------------------1------------------------------------------1------------------
----------------1----------------------------------------1------------------------------------------1------------------
----------------1---XXXXXXXXXXXXXXXXXXXXXXXXXXXXXXX------1------XXXXXXXXXXXXXXXXXXXXXXXXXXXXXXX-----1------------------
----------------1---XXXXXXXXXXXXXXXXXXXXXXXXXXXXXXX------1------XXXXXXXXXXXXXXXXXXXXXXXXXXXXXXX-----1------------------
----------------1---XXXXXXXXXXXXXXXXXXXXXXXXXXXXXXX------1------XXXXXXXXXXXXXXXXXXXXXXXXXXXXXXX-----1------------------
----------------1----------------------------------------1------------------------------------------1------------------
----------------1----------------------------------------1------------------------------------------1------------------
----------------1111111111111111111111111111111111111111111111111111111111111111111111111111111111111------------------
----------------1----------------------------------------1------------------------------------------1------------------
----------------1----------------------------------------1------------------------------------------1------------------
----------------1---XXXXXXXXXXXXXXXXXXXXXXXXXXXXXXX------1------XXXXXXXXXXXXXXXXXXXXXXXXXXXXXXX-----1------------------
----------------1---XXXXXXXXXXXXXXXXXXXXXXXXXXXXXXX------1------XXXXXXXXXXXXXXXXXXXXXXXXXXXXXXX-----1------------------
----------------1---XXXXXXXXXXXXXXXXXXXXXXXXXXXXXXX------1------XXXXXXXXXXXXXXXXXXXXXXXXXXXXXXX-----1------------------
----------------1----------------------------------------1------------------------------------------1------------------
----------------1----------------------------------------1------------------------------------------1------------------
----------------1111111111111111111111111111111111111111111111111111111111111111111111111111111111111------------------
----------------1----------------------------------------1------------------------------------------1------------------
----------------1----------------------------------------1------------------------------------------1------------------
----------------1---XXXXXXXXXXXXXXXXXXXXXXXXXXXXXXX------1------XXXXXXXXXXXXXXXXXXXXXXXXXXXXXXX-----1------------------
----------------1---XXXXXXXXXXXXXXXXXXXXXXXXXXXXXXX------1------XXXXXXXXXXXXXXXXXXXXXXXXXXXXXXX-----1------------------
----------------1---XXXXXXXXXXXXXXXXXXXXXXXXXXXXXXX------1------XXXXXXXXXXXXXXXXXXXXXXXXXXXXXXX-----1------------------
----------------1----------------------------------------1------------------------------------------1------------------
----------------1----------------------------------------1------------------------------------------1------------------
----------------1111111111111111111111111111111111111111111111111111111111111111111111111111111111111------------------
----------------1----------------------------------------1------------------------------------------1------------------
----------------1----------------------------------------1------------------------------------------1------------------
----------------1---XXXXXXXXXXXXXXXXXXXXXXXXXXXXXXX------1------XXXXXXXXXXXXXXXXXXXXXXXXXXXXXXX-----1------------------
----------------1---XXXXXXXXXXXXXXXXXXXXXXXXXXXXXXX------1------XXXXXXXXXXXXXXXXXXXXXXXXXXXXXXX-----1------------------
----------------1---XXXXXXXXXXXXXXXXXXXXXXXXXXXXXXX------1------XXXXXXXXXXXXXXXXXXXXXXXXXXXXXXX-----1------------------
----------------1----------------------------------------1------------------------------------------1------------------
----------------1----------------------------------------1------------------------------------------1------------------
----------------1111111111111111111111111111111111111111111111111111111111111111111111111111111111111------------------
----------------1----------------------------------------1------------------------------------------1------------------
----------------1----------------------------------------1------------------------------------------1------------------
----------------1---XXXXXXXXXXXXXXXXXXXXXXXXXXXXXXX------1------XXXXXXXXXXXXXXXXXXXXXXXXXXXXXXX-----1------------------
----------------1---XXXXXXXXXXXXXXXXXXXXXXXXXXXXXXX------1------XXXXXXXXXXXXXXXXXXXXXXXXXXXXXXX-----1------------------
----------------1---XXXXXXXXXXXXXXXXXXXXXXXXXXXXXXX------1------XXXXXXXXXXXXXXXXXXXXXXXXXXXXXXX-----1------------------
----------------1----------------------------------------1------------------------------------------1------------------
----------------1----------------------------------------1------------------------------------------1------------------
----------------1111111111111111111111111111111111111111111111111111111111111111111111111111111111111------------------
----------------1----------------------------------------1------------------------------------------1------------------
----------------1----------------------------------------1------------------------------------------1------------------
----------------1---XXXXXXXXXXXXXXXXXXXXXXXXXXXXXXX------1------XXXXXXXXXXXXXXXXXXXXXXXXXXXXXXX-----1------------------
----------------1---XXXXXXXXXXXXXXXXXXXXXXXXXXXXXXX------1------XXXXXXXXXXXXXXXXXXXXXXXXXXXXXXX-----1------------------
----------------1---XXXXXXXXXXXXXXXXXXXXXXXXXXXXXXX------1------XXXXXXXXXXXXXXXXXXXXXXXXXXXXXXX-----1------------------
----------------1----------------------------------------1------------------------------------------1------------------
----------------1----------------------------------------1------------------------------------------1------------------
----------------1111111111111111111111111111111111111111111111111111111111111111111111111111111111111------------------
----------------1----------------------------------------1------------------------------------------1------------------
----------------1----------------------------------------1------------------------------------------1------------------
----------------1---XXXXXXXXXXXXXXXXXXXXXXXXXXXXXXX------1------XXXXXXXXXXXXXXXXXXXXXXXXXXXXXXX-----1------------------
----------------1---XXXXXXXXXXXXXXXXXXXXXXXXXXXXXXX------1------XXXXXXXXXXXXXXXXXXXXXXXXXXXXXXX-----1------------------
----------------1---XXXXXXXXXXXXXXXXXXXXXXXXXXXXXXX------1------XXXXXXXXXXXXXXXXXXXXXXXXXXXXXXX-----1------------------
----------------1----------------------------------------1------------------------------------------1------------------
----------------1----------------------------------------1------------------------------------------1------------------
----------------1111111111111111111111111111111111111111111111111111111111111111111111111111111111111------------------
----------------1----------------------------------------1------------------------------------------1------------------
----------------1----------------------------------------1------------------------------------------1------------------
----------------1---XXXXXXXXXXXXXXXXXXXXXXXXXXXXXXX------1------XXXXXXXXXXXXXXXXXXXXXXXXXXXXXXX-----1------------------
----------------1---XXXXXXXXXXXXXXXXXXXXXXXXXXXXXXX------1------XXXXXXXXXXXXXXXXXXXXXXXXXXXXXXX-----1------------------
----------------1---XXXXXXXXXXXXXXXXXXXXXXXXXXXXXXX------1------XXXXXXXXXXXXXXXXXXXXXXXXXXXXXXX-----1------------------
----------------1----------------------------------------1------------------------------------------1------------------
----------------1----------------------------------------1------------------------------------------1------------------
----------------1111111111111111111111111111111111111111111111111111111111111111111111111111111111111------------------
----------------1-----------------------------------------------------------------------------------1------------------
----------------1-----------------------------------------------------------------------------------1------------------
----------------1---XXXXXXXXXXXXXXXXXXXXXXXXXXXXXXXXXXXXXXXXXXXXXXXXXXXXXXXXXXXXXXXXXXXXXXXXXXX-----1------------------
----------------1---XXXXXXXXXXXXXXXXXXXXXXXXXXXXXXXXXXXXXXXXXXXXXXXXXXXXXXXXXXXXXXXXXXXXXXXXXXX-----1------------------
----------------1---XXXXXXXXXXXXXXXXXXXXXXXXXXXXXXXXXXXXXXXXXXXXXXXXXXXXXXXXXXXXXXXXXXXXXXXXXXX-----1------------------
----------------1-----------------------------------------------------------------------------------1------------------
----------------1-----------------------------------------------------------------------------------1------------------
----------------1111111111111111111111111111111111111111111111111111111111111111111111111111111111111------------------
----------------1-----------------------------------------------------------------------------------1------------------
----------------1-----------------------------------------------------------------------------------1------------------
----------------1---XXXXXXXXXXXXXXXXXXXXXXXXXXXXXXXXXXXXXXXXXXXXXXXXXXXXXXXXXXXXXXXXXXXXXXXXXXX-----1------------------
----------------1---XXXXXXXXXXXXXXXXXXXXXXXXXXXXXXXXXXXXXXXXXXXXXXXXXXXXXXXXXXXXXXXXXXXXXXXXXXX-----1------------------
----------------1---XXXXXXXXXXXXXXXXXXXXXXXXXXXXXXXXXXXXXXXXXXXXXXXXXXXXXXXXXXXXXXXXXXXXXXXXXXX-----1------------------
----------------1-----------------------------------------------------------------------------------1------------------
----------------1-----------------------------------------------------------------------------------1------------------
----------------1111111111111111111111111111111111111111111111111111111111111111111111111111111111111------------------
----------------1-----------------------------------------------------------------------------------1------------------
----------------1-----------------------------------------------------------------------------------1------------------
----------------1---XXXXXXXXXXXXXXXXXXXXXXXXXXXXXXXXXXXXXXXXXXXXXXXXXXXXXXXXXXXXXXXXXXXXXXXXXXX-----1------------------
----------------1---XXXXXXXXXXXXXXXXXXXXXXXXXXXXXXXXXXXXXXXXXXXXXXXXXXXXXXXXXXXXXXXXXXXXXXXXXXX-----1------------------
----------------1---XXXXXXXXXXXXXXXXXXXXXXXXXXXXXXXXXXXXXXXXXXXXXXXXXXXXXXXXXXXXXXXXXXXXXXXXXXX-----1------------------
----------------1-----------------------------------------------------------------------------------1------------------
----------------1-----------------------------------------------------------------------------------1------------------
----------------1111111111111111111111111111111111111111111111111111111111111111111111111111111111111------------------
----------------1-----------------------------------------------------------------------------------1------------------
----------------1-----------------------------------------------------------------------------------1------------------
----------------1---XXXXXXXXXXXXXXXXXXXXXXXXXXXXXXXXXXXXXXXXXXXXXXXXXXXXXXXXXXXXXXXXXXXXXXXXXXX-----1------------------
----------------1---XXXXXXXXXXXXXXXXXXXXXXXXXXXXXXXXXXXXXXXXXXXXXXXXXXXXXXXXXXXXXXXXXXXXXXXXXXX-----1------------------
----------------1---XXXXXXXXXXXXXXXXXXXXXXXXXXXXXXXXXXXXXXXXXXXXXXXXXXXXXXXXXXXXXXXXXXXXXXXXXXX-----1------------------
----------------1-----------------------------------------------------------------------------------1------------------
----------------1-----------------------------------------------------------------------------------1------------------
----------------1111111111111111111111111111111111111111111111111111111111111111111111111111111111111------------------